11111111111
1E100000111
100010C0011
100P1000011
11111111111