111111111111
1E100P001C11
1C00100001C1
111111111111