1111111111111111111
1E000000000C0000111
1011110011111111111
1P11110111111111111
11111000C1111111111
1111000111111111111
100C000000000000001
1111111111111000111
100000C0000000CC001
1111111111111111111
