111111111111111i111
11P00000000C0000111
1111110011111111111
1111110111111111111
11111000C1111111111
1111000111111111111
100C000000000000001
1111111111111000111
1E0000C0000000CC001
1111111111111111111
