1111111111111111111111111111
1E1011C100000000000000000001
1010110000000000000000000001
1P000000000000C1C10000100001
1000000000000000100000000001
100C000000000000000010000001
1111111111111111111111111111